key	text	tooltip
#Loc;1;text/db/hkrul_mar_land_units__.loc		
land_units_onscreen_name_hkrul_pg	Pieter de Groot	true
land_units_onscreen_name_hkrul_crispijn	Crispijn van Haagen	true
land_units_onscreen_name_hkrul_solkan	Sword of Solkan	true
land_units_onscreen_name_hkrul_solkan_horse	Sword of Solkan	true
land_units_onscreen_name_hkrul_solkan_mirror	Sword of Solkan	true
land_units_onscreen_name_hkrul_pg_barded_warhorse	Pieter de Groot	true
land_units_onscreen_name_hkrul_jk	Jaan van de Kuypers	true
land_units_onscreen_name_hkrul_jk_barded_warhorse	Jaan van de Kuypers	true
land_units_onscreen_name_hkrul_pion	Golden Pinions (Halberdiers)	true
land_units_onscreen_name_hkrul_klumpf	Van Klumpf's Buccaneers (Swordsmen)	true
land_units_onscreen_name_hkrul_hendrik	Simon Goudenkruin	true
land_units_onscreen_name_hkrul_hendrik_warhorse	Simon Goudenkruin	true
land_units_onscreen_name_hkrul_carriers	Merchant Guild Baggage-Train	true
land_units_onscreen_name_hkrul_burgher	Burgher Militia	true
land_units_onscreen_name_hkrul_mar_handguns	Ships' Crew Gunners	true
land_units_onscreen_name_hkrul_privateers	Marienburg Privateers	true
land_units_onscreen_name_hkrul_privateers_dual_swords	Merchant Guild Sentinels	true
land_units_onscreen_name_hkrul_mar_cav_rijders	Rijders	true
land_units_onscreen_name_hkrul_mar_cav_rijders_crossbow	Rijders (Crossbows)	true
land_units_onscreen_name_hkrul_mar_sons_of_manann	Sons of Manann	true
land_units_onscreen_name_hkrul_mar_inf_goedendagers	Goedendagers	true
land_units_onscreen_name_hkrul_mar_culverin	Culverins	true
land_units_onscreen_name_hkrul_carriers_ror	Van de Kuyper's Treasurers	true
land_units_onscreen_name_hkrul_mar_art_paixhan_ror	Strompoort's Ordnance (Mortars)	true
land_units_onscreen_name_hkrul_mar_mananns_blades_ror	Manann's Blades (Swordsmen)	true
land_units_onscreen_name_hkrul_mar_riverwarden	Riverwardens	true
land_units_onscreen_name_hkrul_mar_riverwarden_ror	Schilder's Toll Collectors (Riverwardens)	true
land_units_onscreen_name_hkrul_mar_qual	Migrated Dwarf Warriors	true
land_units_onscreen_name_hkrul_mar_qual_great	Migrated Quarrellers (Great Weapons)	true
land_units_onscreen_name_hkrul_mar_knights_griffon	Order of the Albatross (Griffon Riders)	true
land_units_onscreen_name_hkrul_hendrik_pegasus	Simon Goudenkruin	true
land_units_onscreen_name_hkrul_mar_bordermen_ror	The Bordermen (Outriders - Grenade Launcher)	false
land_units_onscreen_name_hkrul_mar_egmond	Egmond den Euwe	false
land_units_onscreen_name_hkrul_mar_egmond_horse	Egmond den Euwe	false
land_units_onscreen_name_hkrul_mar_egmond_longma	Egmond den Euwe	false
land_units_onscreen_name_hkrul_mar_defenders	Defenders of the Capital (Greatswords)	false
land_units_onscreen_name_hkrul_mar_teuling	De Teuling's Escort (Empire Knights - Greatswords)	true
land_units_onscreen_name_hkrul_mar_munvard_01	Mundvard the Cruel	true
land_units_onscreen_name_hkrul_mar_munvard_02	Mundvard the Cruel	true
land_units_onscreen_name_hkrul_mar_naval_paixhan	Zegepraal's Paixhan (Great Cannons)	true
land_units_onscreen_name_hkrul_mar_black_caps	Black Caps (Goedendagers)	true
land_units_onscreen_name_hkrul_guzunda	Guzunda Wallrattler	true
land_units_onscreen_name_hkrul_mar_cleansing_flame	Knights of the Cleansing Flame	true
land_units_onscreen_name_hkrul_alicia	Alicia von Unterwald	true
land_units_onscreen_name_hkrul_alicia_horse	Alicia von Unterwald	true
land_units_onscreen_name_hkrul_alicia_hellsteed	Alicia von Unterwald	true
land_units_onscreen_name_hkrul_mar_inf_cairn_wraiths_summoned_0	Cairn Wraiths	true
land_units_onscreen_name_hkrul_lisette	Lisette Leerer	true
land_units_onscreen_name_hkrul_mar_talons	The Red Talons (Handgunners)	true
land_units_onscreen_name_hkrul_cross	Captain Daefvid Maicross	true
land_units_onscreen_name_wh_main_emp_cha_captain_2_jk	Jaan van de Kuypers	false
land_units_onscreen_name_wh3_main_ksl_cha_patriarch_1_jk	Jaan van de Kuypers	false
land_units_onscreen_name_hkrul_mar_caravan_master	Merchant Lord	false
land_units_onscreen_name_hkrul_mar_caravan_master_horse	Merchant Lord	false
land_units_onscreen_name_hkrul_fooger_ror	Fooger's Houseguard (Greatswords)	false
land_units_onscreen_name_rhox_mar_cst_inf_sartosa_free_company_0	Sartosa Free company	false
land_units_concealed_name_rhox_mar_cst_inf_sartosa_free_company_0		false
land_units_onscreen_name_rhox_mar_cst_inf_sartosa_militia_0	Sartosa Militia	false
land_units_concealed_name_rhox_mar_cst_inf_sartosa_militia_0		false
land_units_onscreen_name_hkrul_harb	Odvaal van den Huister	true
land_units_onscreen_name_hkrul_lector_manann_mount	High Priest of Manann	true
land_units_onscreen_name_hkrul_lector_manann	High Priest of Manann	true
land_units_onscreen_name_hkrul_slaver	Master Slavetrader	true
land_units_onscreen_name_ovn_mar_inf_knights_mariner_0	High Temple Guard (Order of the Albatross)	true
land_units_onscreen_name_hkrul_mar_knights_mariner	Knights Mariner (Swordsmen)	true
unit_description_historical_texts_text_hkrul_mar_knights_mariner	Knights Mariner	false
land_units_onscreen_name_hkrul_mar_knights_mariner_fmc	Knights Mariner (Sword & Pistol)	true
land_units_onscreen_name_rhox_mar_mundvard_criminal	Criminal Network Overseer	false
land_units_onscreen_name_urg_dae_inf_sphenisci_daemon	Sphenisci Daemons	false
land_units_onscreen_name_hkrul_dauphine	Camille Dauphina	true
land_units_onscreen_name_hkrul_dauphine_1	Camille Dauphina	true
land_units_onscreen_name_hkrul_dauphine_2	Camille Dauphina	true
land_units_onscreen_name_hkrul_dauphine_3	Camille Dauphina	true
land_units_onscreen_name_hkrul_dauphine_mount	Camille Dauphina	true
land_units_onscreen_name_hkrul_dauphine_mount_2	Camille Dauphina	true
land_units_onscreen_name_hkrul_dauphine_mount_3	Camille Dauphina	true
land_units_onscreen_name_ovn_mar_mon_augas_fish_summoned_0	Augas Swarm	true
unit_description_short_texts_text_ovn_unit_short_text_mar_augas_fish_0	One of the hundreds of strange fish that populates the dark waters of the World, it has a light on top of its head for luring in prey.	true
land_units_onscreen_name_ovn_mar_cha_wizard_sea_0	Sea Magicker	true
ui_unit_groupings_onscreen_wizard_sea	Wizard	true
ui_unit_groupings_tooltip_wizard_sea		true
land_units_onscreen_name_ovn_mar_cha_wizard_sea_1	Sea Magicker	true
land_units_onscreen_name_ovn_mar_cha_wizard_sea_2	Sea Magicker	true
land_units_onscreen_name_hkrul_manann_flagellant	Manann's Fanatics (Flagellants)	false
unit_description_short_texts_text_hkrul_manann_flagellant	These men are often too ill or sickly to be admitted on board of any vessel, yet their fanatism towards Manann might proof useful in some other capacity.	false
land_units_onscreen_name_hkrul_fooger_caravan_master	Dwarf Merchant Lord	false
land_units_onscreen_name_ovn_mar_mon_augas_fish_summoned_1	Ancient Augus	true
unit_description_short_texts_text_ovn_mar_mon_augas_fish_summoned_1	Considered the alma mater of a strange fish that populates the dark waters of the World, the Augus Fish are the Patrons of Lileath.	true
land_units_onscreen_name_chaos_whale_cst_kou	The Red Chaos Whale	false
land_units_onscreen_name_hkrul_arbatt	Captain Aber Walblatt	false
unit_description_short_texts_text_hkrul_chaos_whale	The legendary Red Chaos Whale haunts the seven seas tirelessly, serving Stromfel for eternity.	false
unit_description_historical_texts_text_hkrul_arbatt	Captain Aber Walblatt	false
unit_description_historical_texts_text_hkrul_chaos_whale	Captain Aber Walblatt	false
land_units_onscreen_name_ovn_mar_mon_augas_fish_0	Augas Swarm	false
land_units_onscreen_name_ovn_mar_mon_augas_fish_1	Ancient Augus	false
land_units_onscreen_name_hkrul_arbatt_horse	Captain Aber Walblatt	false
land_units_onscreen_name_hkrul_arbatt_pegasus	Captain Aber Walblatt	false
land_units_onscreen_name_hkrul_fooger_dwarf_lord	House Elder	false
land_units_onscreen_name_hkrul_mar_inf_boogschutter	Burgher Archers	false
land_units_onscreen_name_hkrul_mar_art_scheepskanon	Ship's Canon	false
land_units_onscreen_name_hkrul_mar_inf_greatsword	Adelijken Greatswords	false
land_units_onscreen_name_hkrul_mar_inf_handgun	Kloveniers	false
land_units_onscreen_name_hkrul_fooger	Arkat Fooger	false
land_units_onscreen_name_hkrul_rasha	Rashasawa	true
land_units_onscreen_name_hkrul_ogg	Ogg the Expatriate	true
land_units_onscreen_name_hkrul_paldee	Palldee Hammerbearer	true
land_units_onscreen_name_urg_kho_inf_sphenisci_daemon	Sphenisci Daemons	false
land_units_onscreen_name_urg_nur_inf_sphenisci_daemon	Sphenisci Daemons	false
land_units_onscreen_name_urg_sla_inf_sphenisci_daemon	Sphenisci Daemons	false
land_units_onscreen_name_urg_tze_inf_sphenisci_daemon	Sphenisci Daemons	false
